15
15
|-------------|
|1SS0000000000|
|0H0H0H0H0H0H0|
|0000000000000|
|0H0H0H0H0H0H0|
|0000000000000|
|0H0H0H0H0H0H0|
|0000000000000|
|0H0H0H0H0H0H0|
|0000000000000|
|0H0H0H0H0H0H0|
|0000D00000000|
|0H0H0H0H0H0H0|
|0000000000002|
---------------