15
15
|-------------|
|1000000000000|
|0H0H0H0H0H0H0|
|0000000000000|
|0H0H0H0H0H0H0|
|0000000000000|
|0H0H0H0H0H0H0|
|0000000000000|
|0H0H0H0H0H0H0|
|0000000000000|
|0H0H0H0H0H0H0|
|0000000000000|
|0H0H0H0H0H0H0|
|0000000000002|
---------------