15
15
|-------------|
|1SS0D0S00000S|
|0H0HSH0H0H0HD|
|000000000000S|
|0H0H0H0H0H0HD|
|000000000000S|
|0H0H0H0H0H0H0|
|0000000000000|
|0H0H0H0H0H0H0|
|0000000000000|
|0H0H0H0H0H0H0|
|0000D00000000|
|0H0H0H0H0H0H0|
|0000000000002|
---------------